{
  "df_target_to_id": {
    "%F3885": 0,
    "%F3842": 1,
    "%F3862": 2,
    "%F3284": 3,
    "%F3285": 4,
    "%F3315": 5,
    "%F3282": 6,
    "%F3442": 7
  }
}