{
  "df_target_to_id": {
    "%F3885": 0,
    "%F3842": 1,
    "%F3862": 2,
    "%F3284": 3,
    "%F3285": 4,
    "%F3315": 5,
    "%F3282": 6,
    "%F3442": 7,
    "%F3312": 8,
    "%F3328": 9,
    "%F3580": 10,
    "%F3565": 11,
    "%F3582": 12,
    "%F3591": 13,
    "%F3671": 14
  }
}